149 64 8
0 0 0 0 0 0 0 0 0 0 0 0 0 0 0 0 0 0 0 0 0 0 0 0 0 0 0 0 0 0 0 0 0 0 0 0 0 0 0 0 0 0 0 0 0 0 0 0 0 0 0 0 0 0 0 0 0 0 0 0 0 0 0 0 
0 0 0 0 0 0 0 0 0 0 0 0 0 0 0 0 0 0 0 0 0 0 0 0 0 0 0 0 0 0 0 0 0 0 0 0 0 0 0 0 0 0 0 0 0 0 0 0 0 0 0 0 0 0 0 0 0 0 0 0 0 0 0 0 
1 2 3 4 5 6 7 7 7 7 7 7 7 7 7 7 7 7 7 7 7 7 2 8 6 7 7 7 7 7 2 3 7 4 9 7 7 7 7 7 7 7 7 7 7 7 7 7 7 7 7 7 7 7 7 7 7 7 7 7 7 7 7 7 
10 11 12 13 14 15 16 16 17 18 19 20 21 22 23 24 16 16 25 24 16 16 26 27 15 25 24 16 25 24 26 12 28 13 29 30 16 25 24 16 16 25 24 16 16 16 31 32 33 16 34 35 22 36 34 37 38 22 39 40 16 16 25 24 
41 42 43 44 45 46 47 48 49 50 51 52 53 54 55 56 57 58 35 59 60 61 42 62 46 16 31 63 63 32 64 43 65 44 66 67 47 57 68 33 31 63 32 69 16 68 70 71 72 73 49 50 54 74 75 76 77 54 55 78 79 35 80 59 
81 82 83 84 84 85 86 87 88 88 88 89 90 89 90 91 92 93 94 95 96 97 86 98 85 99 70 100 100 71 101 83 102 84 102 85 86 92 103 104 105 100 71 104 99 106 107 71 101 87 88 88 89 90 89 90 88 89 90 108 93 94 109 95 
110 111 112 112 112 112 112 112 112 112 112 112 112 112 112 112 113 114 115 116 115 116 115 116 115 117 107 100 100 71 118 119 120 121 116 122 112 112 123 124 125 126 127 128 129 130 107 71 118 119 131 119 131 119 131 119 122 112 112 112 112 112 112 112 
132 133 134 134 134 134 134 134 134 134 134 134 134 134 134 134 135 136 137 138 137 138 137 138 137 139 140 141 141 142 138 143 144 145 138 146 134 134 134 134 134 134 134 135 147 139 140 142 138 143 148 143 148 143 148 143 146 134 134 134 134 134 134 134 
