144 96 8
0 0 0 0 0 0 0 0 0 0 0 0 0 0 0 0 0 0 0 0 0 0 0 0 0 0 0 0 0 0 0 0 0 0 0 0 0 0 0 0 0 0 0 0 0 0 0 0 0 0 0 0 0 0 0 0 0 0 0 0 0 0 0 0 0 0 0 0 0 0 0 0 0 0 0 0 0 0 0 0 0 0 0 0 0 0 0 0 0 0 0 0 0 0 0 0 
0 0 0 0 0 0 0 0 0 0 0 0 0 0 0 0 0 0 0 0 0 0 0 0 0 0 0 0 0 0 0 0 0 0 0 0 0 0 0 0 0 0 0 0 0 0 0 0 0 0 0 0 0 0 0 0 0 0 0 0 0 0 0 0 0 0 0 0 0 0 0 0 0 0 0 0 0 0 0 0 0 0 0 0 0 0 0 0 0 0 0 0 0 0 0 0 
1 2 2 2 2 2 2 2 3 4 5 2 2 2 2 3 4 5 2 2 2 6 7 2 2 2 2 2 2 3 4 5 2 2 2 2 2 6 7 2 2 2 3 4 5 2 2 2 2 3 4 5 2 2 2 2 8 2 2 2 2 2 2 2 3 4 5 2 2 6 7 2 2 2 2 8 2 2 2 2 2 2 2 2 2 2 2 3 4 5 2 2 2 6 7 9 
10 11 12 12 13 14 12 12 15 16 17 13 14 12 12 15 16 17 18 19 20 21 22 23 11 12 12 13 14 15 16 17 12 12 24 20 25 26 27 19 28 29 15 16 17 12 13 14 12 15 30 31 20 20 25 23 32 33 34 24 25 23 12 12 15 16 17 12 12 35 36 11 12 12 12 32 33 34 12 12 12 12 37 38 34 12 12 15 16 17 12 11 12 35 36 39 
10 32 33 34 35 36 11 12 12 12 12 35 36 18 19 20 20 20 40 41 42 42 43 44 32 33 34 35 36 45 23 13 14 46 47 42 43 44 48 41 49 50 20 20 20 20 21 51 20 20 40 41 42 42 43 44 15 16 52 47 43 44 12 12 12 12 12 18 19 25 23 32 33 34 12 15 16 17 12 13 14 12 15 16 17 18 19 20 20 25 23 32 33 34 12 53 
10 15 16 17 12 12 32 33 54 19 20 20 20 40 41 42 42 42 55 56 56 56 57 58 15 16 17 45 23 59 44 35 36 12 60 56 61 62 63 56 64 65 66 42 42 42 67 68 66 42 55 56 56 56 69 70 71 72 73 74 57 75 76 77 18 19 20 40 41 43 44 15 16 78 79 29 12 12 18 80 81 29 12 18 19 40 41 42 42 43 44 15 16 17 12 82 
83 20 20 20 20 20 84 85 86 41 42 42 42 55 56 56 56 56 56 56 56 56 57 87 72 76 88 89 90 91 92 20 20 20 93 56 64 94 95 96 97 98 99 64 100 96 97 98 99 64 101 101 100 102 103 104 105 106 107 108 57 109 110 111 112 41 42 55 56 113 50 20 20 40 114 50 20 20 40 41 49 50 20 40 41 55 56 56 56 57 87 72 115 19 20 116 
117 118 118 118 118 118 118 118 119 120 120 120 120 120 120 120 120 120 120 120 120 120 121 122 123 124 125 126 127 128 129 118 118 118 119 120 130 131 131 132 120 120 120 130 131 132 120 120 120 130 131 131 131 133 134 135 135 136 137 138 121 134 139 134 140 120 120 120 120 120 129 118 118 119 120 129 118 118 119 120 120 129 118 119 120 120 120 120 120 121 122 123 141 142 118 143 
